#############
#.B........C#
###.#.#B#D###
  #A#D#C#A#
  #########