#############
#.........A.#
###C#B#.#D###
  #A#B#C#D#
  #########