#############
#...........#
#####A#B#####
    #B#A#
    #####