#############
#...........#
###D#C#C#A###
  #B#B#B#C#
  #D#A#D#B#
  #D#A#A#C#
  #########