#############
#...........#
###A#D#C#D###
  #D#C#D#B#
  #B#A#B#B#
  #C#C#A#A#
  #########