#############
#...........#
###C#A#A#A###
  #C#B#B#B#
  #D#C#C#A#
  #D#D#D#B#
  #########